40
40
20 20 20 20 20 20 20 20 20 20 20 20 20 20 20 20 20 20 20 20 20 20 20 20 20 20 20 20 20 20 20 20 20 20 35 35 35 35 35 35
20 20 20 20 3 1 20 20 20 20 20 20 20 20 20 20 20 20 20 20 20 20 20 20 20 20 20 20 20 20 20 20 20 16 35 35 35 35 35 35
20 20 2 1 1 2 1 3 20 20 2 1 2 20 20 20 20 20 20 20 20 1 1 1 1 20 20 20 20 20 20 1 1 3 16 16 17 35 35 35
20 20 1 1 2 1 1 1 1 1 1 22 22 22 20 20 20 20 20 20 1 1 3 1 1 2 20 20 20 20 1 3 1 1 2 17 16 16 35 35
20 20 1 1 3 1 1 1 1 3 22 22 22 22 20 20 20 20 20 1 2 1 1 2 1 1 1 22 22 1 1 3 1 1 3 17 16 16 17 36
20 20 2 1 1 1 2 1 2 2 22 22 22 22 20 20 20 20 20 1 1 1 1 1 1 2 1 22 22 1 1 1 1 2 17 16 17 35 35 35
20 20 20 3 1 20 20 20 20 2 22 22 22 20 20 20 20 20 1 1 3 3 1 20 20 1 1 22 22 2 1 1 20 17 16 16 35 35 35 35
20 20 20 20 20 20 20 20 20 20 22 22 22 20 20 20 20 20 1 1 20 20 20 20 20 20 20 22 22 22 20 20 20 20 35 35 35 35 35 35
20 20 20 20 20 20 20 20 20 20 22 22 22 20 20 20 20 20 1 1 20 20 20 20 20 20 20 22 22 22 20 20 20 20 20 20 20 20 20 20
20 20 20 20 20 20 20 20 20 1 3 22 22 1 1 20 20 20 1 1 20 20 20 20 20 20 22 22 22 22 20 20 20 20 20 20 20 20 20 20
20 20 20 1 1 1 1 20 20 1 1 22 22 22 1 20 20 1 1 3 1 20 20 20 20 22 22 22 22 22 20 20 20 20 1 3 20 20 20 20
20 20 1 1 3 1 1 20 20 1 22 22 22 22 1 20 20 1 2 1 1 1 20 20 20 22 22 22 22 20 20 20 20 1 1 2 1 20 20 20
20 20 1 3 1 3 1 1 1 1 22 22 22 22 1 1 1 1 1 2 1 2 20 20 20 22 22 20 20 20 20 20 20 1 1 2 1 1 20 20
20 20 1 1 3 1 1 20 20 1 22 22 22 1 3 1 1 1 3 1 1 1 20 20 20 3 1 20 20 1 1 2 1 1 3 1 1 2 20 20
20 20 20 1 1 1 1 20 20 3 1 22 22 2 1 20 20 2 1 1 1 20 20 20 20 1 2 1 20 1 20 20 20 1 1 1 3 20 20 20
20 20 20 20 1 20 20 20 20 20 20 20 20 20 1 20 20 20 20 20 20 20 20 20 20 20 20 1 20 2 20 20 20 20 20 2 1 20 20 20
20 20 20 20 1 20 20 20 20 20 20 20 20 20 1 20 20 20 20 20 20 20 20 20 20 20 20 1 20 1 20 20 20 20 1 1 1 1 20 20
20 20 20 20 21 20 20 20 20 20 20 1 2 1 1 20 20 2 2 1 1 1 1 20 20 2 2 1 20 2 20 20 20 20 2 1 1 1 20 20
20 20 2 3 1 20 20 20 20 20 1 3 20 20 20 20 20 3 1 1 2 2 1 20 20 21 20 20 20 1 2 20 20 20 20 2 1 2 20 20
20 20 1 20 20 20 20 20 20 1 1 20 20 20 20 20 20 1 1 1 3 1 1 20 20 3 1 1 20 20 1 20 20 20 20 20 1 2 20 20
20 20 3 2 2 1 1 3 1 1 1 20 20 20 1 1 21 1 3 1 1 1 1 20 20 1 20 2 3 1 1 20 20 20 20 20 2 1 20 20
20 20 20 20 20 20 20 20 20 2 1 1 20 20 20 20 20 1 2 2 1 3 1 20 20 2 20 20 20 20 20 20 20 20 20 20 1 2 20 20
20 20 20 20 20 20 20 20 20 20 3 1 20 20 20 20 20 1 1 1 1 2 2 20 20 1 3 1 3 1 1 20 20 20 20 20 1 2 20 20
20 20 20 20 20 20 20 20 20 20 20 1 20 20 20 20 20 20 20 20 20 20 20 20 20 20 20 20 20 20 1 20 20 20 20 20 1 20 20 20
20 20 20 20 20 20 20 20 20 20 20 21 20 20 20 20 20 20 20 2 1 20 20 20 20 20 20 20 20 20 1 20 20 20 20 20 1 20 20 20
20 20 20 20 20 20 20 20 20 20 20 1 22 20 20 20 20 20 3 1 1 20 20 20 20 20 20 1 1 1 3 20 20 20 20 20 2 3 2 20
20 20 20 1 3 20 20 20 20 1 2 1 22 22 20 20 20 20 2 2 1 2 20 20 20 20 1 2 2 2 1 20 20 20 20 20 3 1 3 20
20 20 1 1 1 2 1 20 1 1 3 22 22 22 22 20 20 20 2 2 2 2 20 20 20 1 1 1 3 1 2 1 1 3 20 20 20 3 2 20
20 20 1 2 1 2 3 20 1 1 22 22 22 22 1 20 20 1 2 1 2 2 20 20 20 1 1 2 1 1 2 1 2 2 1 20 20 20 20 20
20 20 20 1 1 1 1 20 20 20 22 22 22 2 1 1 1 1 1 1 1 3 20 20 20 1 2 3 1 2 20 20 20 3 1 22 22 22 22 20
20 20 20 3 1 1 1 20 20 20 20 22 22 20 20 20 20 1 3 20 20 1 1 1 1 1 2 1 1 20 20 20 20 1 22 22 22 22 22 20
20 20 20 2 1 20 20 20 20 20 20 20 20 20 20 20 20 20 20 20 20 20 20 20 20 20 20 20 20 20 20 20 20 20 20 22 22 22 22 20
20 20 20 1 1 20 20 20 20 20 20 20 20 20 20 20 20 1 20 20 20 1 20 20 20 20 20 20 20 20 20 20 20 1 1 22 9 9 22 20
20 20 20 1 1 20 20 20 20 20 20 20 20 20 1 1 1 3 20 20 20 1 1 1 1 3 1 20 20 20 20 20 25 1 27 9 9 9 9 6
20 20 1 3 1 20 20 20 20 20 20 3 1 1 2 20 20 20 20 20 20 1 3 1 2 1 2 1 20 20 20 20 25 6 27 9 9 9 9 25
20 20 2 1 1 20 20 20 20 20 20 2 20 20 20 20 20 20 20 20 1 2 1 3 1 3 2 3 1 20 20 20 25 6 6 27 9 9 27 25
20 20 1 1 2 1 20 20 20 20 20 21 20 20 20 20 20 20 20 20 1 1 1 1 2 1 2 1 1 20 20 20 25 25 6 6 27 27 25 25
20 20 20 1 3 1 1 1 1 1 1 1 20 20 20 20 20 20 20 20 20 3 1 1 3 1 1 1 20 20 20 20 25 25 25 6 6 6 25 25
20 20 20 20 1 2 20 20 20 20 20 20 20 20 20 20 20 20 20 20 20 20 20 20 20 1 1 20 20 20 20 20 25 25 25 25 6 25 25 25
20 20 20 20 20 20 20 20 20 20 20 20 20 20 20 20 20 20 20 20 20 20 20 20 20 20 20 20 20 20 20 20 25 25 25 25 25 25 25 25
