40
80
20 20 20 20 20 20 20 20 20 20 20 20 20 20 20 20 20 20 20 20 20 20 20 20 20 20 20 20 20 20 20 20 20 20 35 35 35 35 35 35
20 20 20 20 3 1 20 20 20 20 20 20 20 20 20 20 20 20 20 20 20 20 20 20 20 20 20 20 20 20 20 20 20 16 35 35 35 35 35 35
20 20 2 1 1 2 1 3 20 20 2 1 2 20 20 20 20 20 20 20 20 1 1 1 1 20 20 20 20 20 20 1 1 3 16 16 17 35 35 35
20 20 1 1 2 1 1 1 1 1 1 22 22 22 20 20 20 20 20 20 1 1 3 1 1 2 20 20 20 20 1 3 1 1 2 17 16 16 35 35
20 20 1 1 3 1 1 1 1 3 22 22 22 22 20 20 20 20 20 1 2 1 1 2 1 1 1 22 22 1 1 3 1 1 3 17 16 16 17 34
20 20 2 1 1 1 2 1 2 2 22 22 22 22 20 20 20 20 20 1 1 1 1 1 1 2 1 22 22 1 1 1 1 2 17 16 17 35 35 35
20 20 20 3 1 20 20 20 20 2 22 22 22 20 20 20 20 20 1 1 3 3 1 20 20 1 1 22 22 2 1 1 20 17 16 16 35 35 35 35
20 20 20 20 20 20 20 20 20 20 22 22 22 20 20 20 20 20 1 1 20 20 20 20 20 20 20 22 22 22 20 20 20 20 35 35 35 35 35 35
20 20 20 20 20 20 20 20 20 20 22 22 22 20 20 20 20 20 1 1 20 20 20 20 20 20 20 22 22 22 20 20 20 20 20 20 20 20 20 20
20 20 20 20 20 20 20 20 20 1 3 22 22 1 1 20 20 20 20 21 20 20 20 20 20 20 22 22 22 22 20 20 20 20 20 20 20 20 20 20
20 20 20 1 1 1 1 20 20 1 1 22 22 22 1 20 20 1 1 3 1 20 20 20 20 22 22 22 22 22 20 20 20 20 1 3 20 20 20 20
20 20 1 1 3 1 1 20 20 1 22 22 22 22 1 20 20 1 2 1 1 1 20 20 20 22 22 22 22 20 20 20 20 1 1 2 1 20 20 20
20 20 1 3 1 3 1 1 1 1 22 22 22 22 1 1 1 1 1 2 1 2 20 20 20 22 22 20 20 20 20 20 20 1 1 2 1 1 20 20
20 20 1 1 3 1 1 20 20 1 22 22 22 1 3 1 1 1 3 1 1 1 20 20 20 3 1 20 20 1 1 2 1 1 3 1 1 2 20 20
20 20 20 1 1 1 1 20 20 3 1 22 22 2 1 20 20 2 1 1 1 20 20 20 20 1 2 1 20 1 20 20 20 1 1 1 3 20 20 20
20 20 20 20 1 20 20 20 20 20 20 20 20 20 1 20 20 20 20 20 20 20 20 20 20 20 20 1 20 2 20 20 20 20 20 2 1 20 20 20
20 20 20 20 1 20 20 20 20 20 20 20 20 20 1 20 8 8 8 8 8 8 8 8 20 20 20 1 20 1 20 20 20 20 1 1 1 1 20 20
20 20 20 20 21 20 20 20 20 20 20 1 2 1 1 20 8 1 1 1 2 1 1 8 20 2 2 1 20 2 20 20 20 20 2 1 1 1 20 20
20 20 2 3 1 20 20 20 20 20 1 3 20 20 20 20 8 1 3 1 1 2 1 8 20 21 20 20 20 1 2 20 20 20 20 2 1 2 20 20
20 20 1 20 20 20 20 20 20 1 1 20 20 20 20 20 8 1 1 1 1 2 3 8 20 3 1 1 20 20 1 20 20 20 20 20 1 2 20 20
20 20 3 2 2 1 1 3 1 1 1 20 20 20 1 1 21 1 2 3 1 1 2 8 20 1 20 2 3 1 1 20 20 20 20 20 2 1 20 20
20 20 20 20 20 20 20 20 20 2 1 1 20 20 20 20 8 1 1 2 1 1 1 8 20 2 20 20 20 20 20 20 20 20 20 20 1 2 20 20
20 20 20 20 20 20 20 20 20 20 3 1 20 20 20 20 8 3 2 1 1 1 3 8 20 1 3 1 3 1 1 20 20 20 20 20 1 2 20 20
20 20 20 20 20 20 20 20 20 20 20 1 20 20 20 20 8 8 8 8 0 8 8 8 20 20 20 20 20 20 1 20 20 20 20 20 1 20 20 20
20 20 20 20 20 20 20 20 20 20 20 21 20 20 20 20 20 20 20 20 1 20 20 20 20 20 20 20 20 20 1 20 20 20 20 20 1 20 20 20
20 20 20 20 20 20 20 20 20 20 20 1 22 20 20 20 20 20 20 3 1 20 20 20 20 20 20 1 1 1 3 20 20 20 20 20 2 3 2 20
20 20 20 1 3 20 20 20 20 1 2 1 22 22 20 20 20 20 3 2 1 2 20 20 20 20 1 2 2 2 1 20 20 20 20 20 3 1 3 20
20 20 1 1 1 2 1 20 1 1 3 22 22 22 22 20 20 20 2 2 2 2 20 20 20 1 1 1 3 1 2 1 1 3 20 20 20 3 2 20
20 20 1 2 1 2 3 20 1 1 22 22 22 22 1 20 20 1 2 1 2 2 20 20 20 1 1 2 1 1 2 1 2 2 1 20 20 20 20 20
20 20 20 1 1 1 1 20 20 20 22 22 22 2 1 1 1 1 1 1 1 3 20 20 20 1 2 3 1 2 20 20 20 3 1 22 22 22 22 20
20 20 20 3 1 1 1 20 20 20 20 22 22 20 20 20 20 1 3 20 20 1 1 1 1 1 2 1 1 20 20 20 20 1 22 22 22 22 22 20
20 20 20 2 1 20 20 20 20 20 20 20 20 20 20 20 20 20 20 20 20 20 20 20 20 20 20 20 20 20 20 20 20 20 20 22 22 22 22 20
20 20 20 1 1 20 20 20 20 20 20 20 20 20 20 20 20 1 20 20 20 1 20 20 20 20 20 20 20 20 20 20 20 1 1 22 27 27 22 20
20 20 20 1 1 20 20 20 20 20 20 20 20 20 1 1 1 3 20 20 20 1 1 1 1 3 1 20 20 20 20 20 25 1 27 27 27 27 27 6
20 20 1 3 1 20 20 20 20 20 20 3 1 1 2 20 20 20 20 20 20 1 3 1 2 1 2 1 20 20 20 20 25 6 27 27 27 27 27 25
20 20 2 1 1 20 20 20 20 20 20 2 20 20 20 20 20 20 20 20 1 2 1 3 1 3 2 3 1 20 20 20 25 6 6 27 27 27 27 25
20 20 1 1 2 1 20 20 20 20 20 21 20 20 20 20 20 20 20 20 1 1 1 1 2 1 2 1 1 20 20 20 25 25 6 6 27 27 25 25
20 20 20 1 3 1 1 1 1 1 1 1 20 20 20 20 20 20 20 20 20 3 1 1 3 1 1 1 20 20 20 20 25 25 25 6 6 6 25 25
20 20 20 20 1 2 20 20 20 20 20 20 20 20 20 20 20 20 20 20 20 20 20 20 20 1 1 20 20 20 20 20 25 25 25 25 6 25 25 25
20 20 20 20 20 20 20 20 20 20 20 20 20 20 20 20 20 20 20 20 20 20 20 20 20 20 20 20 20 20 20 20 25 25 25 25 24 25 25 25
25 25 25 25 25 25 25 25 25 25 25 25 25 25 25 25 25 25 25 25 25 25 25 25 25 25 25 25 25 25 25 25 25 25 25 25 6 6 6 25
25 25 6 7 7 7 7 7 7 7 7 7 7 7 25 25 25 25 25 25 25 25 6 6 25 6 6 6 6 6 6 25 25 25 25 25 6 6 6 25
25 6 7 7 27 27 27 27 27 27 27 27 7 7 7 25 6 26 6 6 6 6 6 6 25 25 25 25 25 6 6 25 25 25 25 25 25 25 6 25
25 7 27 27 27 27 27 27 27 6 6 27 27 7 7 25 6 25 6 6 6 7 6 6 25 6 6 25 25 25 6 6 6 6 25 25 25 25 6 25
25 7 7 27 27 27 27 27 27 6 6 27 27 27 7 25 6 25 6 6 7 7 7 6 25 25 6 6 6 6 6 6 6 6 25 25 25 25 6 25
25 7 7 7 27 27 27 27 27 27 27 27 27 7 6 26 6 25 6 7 7 27 7 7 25 25 25 25 25 6 6 25 25 6 6 6 6 6 6 25
25 25 7 7 7 7 7 7 7 7 7 7 7 6 25 25 25 6 7 7 27 27 27 7 25 25 25 25 25 25 25 25 25 25 25 25 26 25 25 25
25 25 25 25 25 25 25 25 25 25 25 25 25 25 25 25 25 7 7 7 27 9 27 7 25 25 25 25 25 25 25 25 25 25 25 25 6 25 25 25
25 25 25 25 25 25 25 25 25 25 25 25 25 25 25 25 25 7 7 27 27 9 27 7 25 25 25 25 25 25 25 25 25 25 25 25 6 25 25 25
25 25 25 6 6 25 25 25 25 25 25 6 7 7 7 25 25 7 27 27 9 9 27 7 7 7 7 7 7 25 6 25 25 25 25 6 6 25 25 25
25 25 6 6 6 6 6 25 25 25 25 7 7 4 4 25 25 7 27 9 9 9 27 27 27 27 27 27 7 7 26 25 25 25 6 6 6 6 25 25
25 6 6 6 6 6 6 26 6 25 7 7 4 4 9 27 27 27 27 9 9 9 9 9 9 9 9 27 27 7 6 25 25 6 6 6 6 6 6 25
25 6 6 6 6 6 6 25 25 7 7 4 4 9 9 9 9 9 9 9 9 9 9 9 9 9 9 9 27 27 7 25 25 6 6 6 6 6 6 25
25 6 6 6 6 6 25 25 25 7 4 4 9 9 9 9 9 9 9 9 9 9 9 9 9 9 9 9 9 27 7 25 25 6 6 6 6 6 6 25
25 6 6 6 6 25 25 25 25 7 4 9 9 9 9 9 9 9 9 9 9 9 9 9 9 9 9 9 9 27 7 25 25 25 6 6 6 6 25 25
25 6 6 6 25 25 25 25 25 27 27 9 9 9 9 8 8 8 8 8 8 8 8 8 8 9 9 9 9 27 7 25 25 25 6 6 6 25 25 25
25 6 25 25 25 25 25 25 25 27 9 9 9 9 9 8 25 25 25 25 25 25 25 25 8 9 9 9 9 27 7 25 25 25 25 6 6 25 25 25
25 6 6 6 6 6 6 25 25 9 9 9 9 9 9 8 25 25 25 25 6 6 25 25 8 9 9 9 9 27 7 25 25 25 25 6 6 6 25 25
25 25 25 25 25 25 6 25 25 9 9 9 9 9 9 8 25 25 6 6 6 8 6 25 8 9 9 9 9 27 7 25 25 25 6 6 6 6 25 25
25 6 6 6 6 6 6 25 25 9 9 9 9 9 9 8 25 25 6 6 8 8 8 25 8 9 9 9 9 27 7 25 25 25 6 6 6 6 25 25
25 26 25 25 25 25 6 25 25 9 9 9 9 9 9 8 25 6 6 6 8 6 8 25 8 9 9 9 9 27 7 25 25 25 6 6 6 6 25 25
25 6 6 25 25 25 25 25 25 9 9 9 9 9 9 8 7 6 6 6 8 6 8 6 8 9 9 9 27 27 7 25 25 6 6 6 6 6 6 25
25 6 6 6 6 6 6 25 25 9 9 9 9 9 9 8 7 7 6 6 6 6 6 7 8 9 9 9 27 7 25 25 25 6 6 6 6 6 6 25
25 25 25 25 25 25 25 25 25 9 9 9 9 9 9 8 7 7 7 6 6 7 7 7 8 9 9 9 27 7 25 25 25 6 6 6 6 6 6 25
25 25 25 25 25 25 6 25 25 9 9 9 9 9 9 8 8 7 7 7 7 7 7 8 8 9 9 9 27 7 25 25 25 6 6 6 6 6 6 25
25 25 25 25 25 25 6 25 25 27 27 9 9 9 9 9 4 27 7 7 7 7 27 27 9 9 9 9 27 7 25 25 25 6 6 6 6 6 6 25
25 25 25 25 25 25 6 25 25 7 27 27 9 9 9 9 9 27 27 7 7 27 27 9 9 9 9 9 27 27 7 25 25 6 6 6 6 6 6 25
25 25 25 25 25 25 6 25 25 7 7 27 27 9 9 9 9 9 27 27 27 27 9 9 9 9 9 27 27 27 7 25 25 6 6 12 6 6 6 25
25 25 25 25 25 6 6 25 25 6 7 7 27 27 9 9 9 9 9 9 9 9 9 9 9 27 27 27 27 7 7 25 25 6 6 11 12 11 6 25
25 25 25 25 6 6 6 25 25 25 6 7 7 27 27 25 9 9 9 9 9 9 9 9 25 27 27 7 7 7 25 25 25 6 11 12 11 11 11 25
25 25 25 6 6 6 25 25 25 6 26 25 7 7 7 25 7 7 7 7 7 7 7 7 25 7 7 7 7 25 25 25 25 6 11 13 11 12 11 25
25 25 6 6 6 25 25 25 25 25 25 25 25 25 25 25 25 25 25 26 25 25 25 25 25 25 25 25 25 25 25 25 30 11 12 11 13 11 11 30
25 25 25 25 25 25 25 25 25 25 25 25 25 25 25 25 25 25 25 6 25 25 25 25 25 25 25 25 25 25 25 25 30 11 11 11 12 11 11 30
25 25 6 25 25 6 6 6 6 6 6 6 6 6 6 25 25 25 25 6 25 6 6 25 25 6 6 25 25 25 25 25 30 11 11 11 11 11 11 30
25 25 6 25 25 6 6 25 25 25 25 25 25 25 26 25 25 25 25 6 25 25 6 6 6 6 6 6 6 25 25 25 30 11 13 11 11 11 12 30
25 25 6 25 25 6 6 25 25 6 6 6 6 6 6 25 25 25 6 6 25 25 6 6 6 6 6 6 6 6 25 25 30 12 11 11 11 12 11 30
25 6 6 25 25 6 25 25 25 6 25 25 25 25 25 25 25 25 6 6 6 25 6 6 25 6 6 6 6 6 25 25 30 30 12 11 13 11 11 30
25 6 6 6 25 6 25 25 25 6 6 25 25 25 25 25 25 25 6 6 6 25 6 25 25 6 6 6 6 25 25 25 30 30 11 12 11 13 11 29
25 25 6 6 6 6 25 25 25 25 6 6 6 6 6 6 6 6 6 6 6 6 6 25 25 25 25 25 25 25 25 25 30 30 30 30 12 11 11 30
25 25 25 25 25 25 25 25 25 25 25 25 25 25 25 25 25 25 25 25 25 25 25 25 25 25 25 25 25 25 25 25 30 30 30 30 30 30 30 30
